w w w w w w w w w w w w w w w w w w w w w w w w w w w w  
w o o o o o o o o o o o o w w o o o o o o o o o o o o w                      
w o w w w w o w w w w w o w w o w w w w w o w w w w o w 
w O w w w w o w w w w w o w w o w w w w w o w w w w O w 
w o w w w w o w w w w w o w w o w w w w w o w w w w o w           
w o o o o o o o o o o o o o o o o o o o o o o o o o o w 
w o w w w w o w w o w w w w w w w w o w w o w w w w o w 
w o w w w w o w w o w w w w w w w w o w w o w w w w o w 
w o o o o o o w w o o o o w w o o o o w w o o o o o o w 
w w w w w w o w w w w w e w w e w w w w w o w w w w w w 
x x x x x w o w w w w w e w w e w w w w w o w x x x x x 
x x x x x w o w w e e e e e e e e e e w w o w x x x x x 
x x x x x w o w w e w w w e e w w w e w w o w x x x x x 
w w w w w w o w w e w e e e e e e w e w w o w w w w w w 
e e e e e e o e e e w e g e e g e w e e e o e e e e e e 
w w w w w w o w w e w e e e e e e w e w w o w w w w w w 
x x x x x w o w w e w w w w w w w w o w w o w x x x x x 
x x x x x w o w w e e e e e e e e e e w w o w x x x x x 
x x x x x w o w w e w w w w w w w w e w w o w x x x x x 
w w w w w w o w w e w w w w w w w w e w w o w w w w w w 
w o o o o o o o o o o o o w w o o o o o o o o o o o o w 
w o w w w w o w w w w w o w w o w w w w w o w w w w o w 
w O w w w w o w w w w w o w w o w w w w w o w w w w O w 
w o o o w w o o o o o o o p o o o o o o o o w w o o o w 
w w w o w w o w w o w w w w w w w w o w w o w w o w w w 
w w w o w w o w w o w w w w w w w w o w w o w w o w w w 
w o o o o o o w w o o o o w w o o o o w w o o o o o o w 
w o w w w w w w w w w w o w w o w w w w w w w w w w o w 
w o w w w w w w w w w w o w w o w w w w w w w w w w o w 
w o o o o o o o o o o o o o o o o o o o o o o o o o o w 
w w w w w w w w w w w w w w w w w w w w w w w w w w w w 
